....#...##.#.........#....#....
#.......#...#...#.#............
#..#..#.#.##....#.#........#...
........##...................#.
........#...##...#.#.###.......
##............#...#.....#.##...
...........#....###...#.....#..
.......#......#..##..#.....#...
..#.#..#....#.........#...#..#.
.........##......#.....##..##..
........#.....#....#..##......#
..#..#.......#..............#..
.....#.#.......................
.#.#....#.........#............
.......#.....#.###.............
......##......#...........#..#.
.#...............##...#........
.....#..##........###.........#
#...........#..#............#..
.........#....#..#.#......#....
.......#.........#..##.........
.##.....#..................#...
....#............#.#....#.....#
..#....#...##....#...#.#...#...
..........#................#.#.
#...#.#.#.####..#.#..........#.
..#...#.##......#...........#..
..#.....#...#.......#......#..#
..............#.......#........
.#..#..........#.....#...#..#.#
#........#...#......#.......#..
#..................#...........
..#...#........#...#..#........
..............#.....#.....#..#.
#.#.......#..............##.##.
....#.#.....##....#...........#
......#....#...#..#.......#....
....#..#.#.....#..##.....#....#
...........#.......#.#.#.......
#.......#..##........#..#......
.........#.##..#..............#
...........#............###.#..
..#.....#.....##...#.........#.
....##............##........#..
.....###..........#......##....
#...##..#..#..........#........
....#.....#.......#..#.#...##..
.#....#........#.#.........#.#.
##...#.#.....#......#..........
.....##.....#....#.....###.#..#
..............#..###..#...#..#.
....#...#....#.............#.#.
.#.........#.....#........#.##.
....#.........#..........#.....
.......#........#.#.#..........
#........##....#.........#.....
..##..........#....#.#...#....#
#...#.#......#..##..........#.#
.....#..#...#..#...............
#...#..............#...........
.#...#....#..##.....#....#.#...
.#...#.......#...#..#.##....#..
#....#........#....#...#.......
#..#......#.....#.....#..##....
......#.#....##....##..#...#...
..#....#.#.###..............#..
.#.##.......#.#.#..#...#..#....
..#..........#.#....#..#.#....#
..........#...#...#..........#.
..........#.....#.#..#..#....##
.#.#...##...#...........####...
........##..#.#..........#.##.#
#......###...........#...#.....
..#.#....##.........##....#....
#....#.##..##..#..#.....#.....#
.##.....##....##....#.......#..
#...#.....##....#..........#...
............#.#.##....#....#...
....#............#.....#......#
....................#..........
..#....................#..#....
....#.....#........#..##...#...
#.....#.#....................##
.#....#.#.#...#..........#....#
....#...#......#...#.....##...#
.....#.........................
.......#..#.#...#...#...#.....#
...#......#.##.#...#..#...##.#.
...........................#..#
..#.#.....#........##..........
....#...##........#.#.#..#...##
..##.....#..###.........##.##..
.#..#.....#...#.............#..
#..............##...#....##....
.##......#.#............#......
.............##...#.#.......#..
.........#..#..#...............
........##......#....##........
...#.........#.#.#.............
#..........#......#......#..#..
.............##.#.#..#.#.#...#.
.....#.........#...............
..##.#..#.....##..#........#.#.
.#..........#.#.......#......##
.#........................#....
#....#....#...#..#......#......
........#.......#......#.....#.
.....#....##..#...###...#....#.
....#.........#....#......#....
.............#...#....#.......#
.....#.........#..#.#..........
.........#..#........#.#.#.....
......#.##......#....#.#.##.#..
.#...#.#...#...#.#......#....##
.#................#......#.....
#.#.#...............#..........
.....#.#.......#...#........#..
#...#.#.#.##..#...........#..#.
.............###.........#....#
.#.....#.......##....##.......#
....#...#.......#.##.....#.....
...........##.........#...#....
..............#.#..#.....#..#..
#.#...#..#.#.........#......#.#
#.##.....##....#........#.#.#.#
##.#.###.........##.......#..#.
#.....#.....................#..
.........##........#..........
.###........##....#...#........
....#.#........##...........#..
..........#.....#..........#..#
......#..............#......#..
.....#...#......#...#...#......
..........#.#..#....#...#..###.
#..##........#................#
..#............................
.....#.........#.#.............
........#...#.....#...##......#
..#........#................#..
......#....#..#......#.........
...........##....#..#.#........
.....#.............###.........
#............#......#..#.......
..#..#.................#..#..##
.......#......#.....#........#.
....................#..#.##...#
.#..##...............##...#....
...#...#....#........#.........
.....##...#.....###............
.###.........#........#.....##.
.............#...#.............
...#.#...............#..##..#.#
...#...............#..#.....#..
....#.#..................#...#.
..........#...........#.#...###
#...#......#................#..
...#.#.......#...#......#.##...
......#..........#.............
##.......#.##.#...........#....
......#...#.#.....#............
.#.....#.....#.....#.........#.
..................#............
.#.#.#.....#......#.##.........
.......#..##.##......#..#....#.
...#.#.#......#...#........#...
..#............#......#.......#
..#......#........#.........#..
..#..#.#.#.....#.............#.
..#.#..##......#...#...##......
.##...#....##.#.#...........#..
..............#..#...#....#....
.......#.#........#............
.....##..###........#..........
......................#........
..##....#....#.................
.##.#.###.#........#.##..#...#.
##................#...........#
....#..##.....##...............
.#.....#..#............#.....#.
#.........#..............#.....
...##.#......#...#.............
................#..............
...#.....#....##...#..#....#...
..............##..#...#.##..#..
......................#..#....#
.......#....#..#.##.........#.#
#...#........##.......#........
...##...............#.....#....
.##...##...#...................
.........##.#...#.........#....
............#............#..#..
.............................#.
....#.#....#...................
......#......#...#..##.........
#........#.#.#.#.#......#....#.
.#.........#.#...#......#..#.#.
..............#....##.........#
.#.......#..#....#.#.#....#....
...###.#.#..#...#....#....#....
#........#....................#
......#...##.###..#..##...#....
.....#........#.......#........
#..#...........#.#.............
....##.#...#..##............##.
#.#..##..#...#...#.....#.......
..#.............#.##..#...#.##.
.#.....##.#..#...#...........#.
....#...#....................##
....##......#.###......#......#
...#...#.........#..#.##....#..
#......#..#....###.........#...
#...........##.............#.#.
#..............##....#......#..
.........#...#.#...#...#.......
....#....#............#.......#
........#...#....#......##.....
..........#.#..#.........#.....
#........#.##....##......#.....
...#.......#...................
###...#...#..#.##....#.....#...
........##..........#.##..#....
.....#......#..#.....#.....#.#.
...#..#..##..###.....##.#......
#..#......##...#............#..
#............#....#..#.........
#........#.......#......#..##.#
...#.#.........#.#.............
#..............#..............#
#.#......#..........##.........
#..##...........#..##...#......
.....#.#.....#......#.....#.#.#
.#.##...#...##...........#....#
#.............#........#.......
..##.............#...#.........
....#.#......###....#..........
...#..#.....#..##.#....#...#.#.
.............##................
#.#............#........#..#.#.
.#......#.....#...........#....
...#.........#...........#.##..
.....#...#.....#..#..........#.
........#.#...............#.#..
.......#..#..#.....#.......##..
.#...#...#..#...##...#.........
..........##....#..#.##..#.....
....#.................#...#....
.........#...#......#....#....#
.........#..#...#.##........##.
#.#....##.......#.#............
##.......##..................#.
......#...#......##............
##.#...#.#...........#..#......
.........#.........#..#.#...#..
.#...#.......#.#...###.........
................#.#.....#......
..#...#.....#........#.........
.........##.###.#.#.....#...#..
#..#..........#....#.#...#...##
##.#.#....#..##.............#.#
.###....#..#...............##..
............#......#.#.#....#..
........#...#..#...#...........
##.........#................#..
...###...#.#..#...#..........##
...#......#......##........#...
.......#............#..........
.....#.....##....#.....###.....
.#...#...#.....#..#..#....#..#.
#.#........#..#.......##...#.##
.....#.....##..#.##........#..#
.....#...#...........#.........
..#....#.#...#..#....##...#...#
...........#...##.........#....
..#....#....##........#.####...
#.............#.#.............#
...................#.....#.#..#
.#....#.#.............#.#......
#...........#............#.#...
..#.........#.#....#.......##..
#....####......#...#......#....
....##....#...................#
....#.##....#.............#....
.........##........#.....#..#..
............#...#..............
............#..##....#.....##.#
............#.....#......#.....
........#..#........##.#.......
...#.#........#..............#.
............#.........#..#.#...
................#.............#
..##..........##......#.#......
..#..#.##....#.........#...#...
...........##...#.#.#..........
.#.#.......#.#...#.........#...
.........#..#........#..#.#....
..........##..#.##....#....#...
....#...............#.......#..
##..........##.................
....#.#.#.....#..........##.#..
..............#.##..........##.
##...............#...#..#......
..#..#..........#......#.......
#...#..##.#.#..................
....#....##......##.#...#....##
.#...#.#....##.............#..#
................#......###.....
..#..#.............#.#.......#.
..#..................#.......#.
.....#.......#....#.##...#.##..
.....##.......#......#..#......
#..#.......#........#..........
..#...#..#....#.........#......
#..#..#......##..#.##....####..
......##.#.....#..#.......#....
.##...#.....#..#...#.#.........
#.....#........###....#...#..#.
.#....#.#..#......#............
.........#..#..#.....#........#
..#.......#..........#..#......
......#.......##.#....#.#.#....
.#............#.....#.......#..
...#..#...............#........
.....#..........................
